{"levels": [
	{
		"level": 1,
		"activeBricksAmount": 42,
		"positions": [
						[1,1,1,1,1,1,1,1,1,1,1],
						[2,5,2,2,2,2,2,2,2,5,2],
						[1,1,1,1,1,1,1,1,1,1,1],
						[2,2,2,2,2,2,2,2,2,2,2]
		]
	},
	{
		"level": 2,
		"activeBricksAmount": 41,
		"positions": [
						[1,1,1,1,1,1,1,1,1,1,1],
						[3,3,3,3,3,5,3,3,3,3,3],
						[2,5,2,2,2,2,2,2,2,5,2],
						[1,1,1,1,1,1,1,1,1,1,1]
		]
	},
	{
		"level": 3,
		"activeBricksAmount": 39,
		"positions": [
						[4,4,4,4,4,4,4,4,4,4,4],
						[3,3,3,3,3,3,3,3,3,3,3],
						[2,5,2,5,2,5,2,5,2,5,2],
						[1,1,1,1,1,1,1,1,1,1,1]
		]
	}
]
}