{"levels": [
	{
		"level": 1,
		"activeBricksAmount": 11,
		"disactiveBricksAmount": 2,
		"positions": [
						[0,0,0,0,0,0,0,0,0,0,0],
						[2,2,2,2,2,2,2,2,2,2,2],
						[0,0,5,0,0,0,0,0,5,0,0],
						[0,0,0,0,0,0,0,0,0,0,0]
		]
	},
	{
		"level": 2,
		"activeBricksAmount": 11,
		"positions": [
						[0,0,0,0,0,0,0,0,0,0,0],
						[5,0,0,0,0,5,0,0,0,0,5],
						[0,0,0,0,0,0,0,0,0,0,0],
						[1,1,1,1,1,1,1,1,1,1,1]
		]
	},
	{
		"level": 3,
		"activeBricksAmount": 11,
		"positions": [
						[0,0,0,0,0,0,0,0,0,0,0],
						[3,3,3,3,3,3,3,3,3,3,3],
						[0,5,0,5,0,5,0,5,0,5,0],
						[0,0,0,0,0,0,0,0,0,0,0]
		]
	}
]
}